"Vaccinedato";"geo";"Antal færdigvacc. personer";"Antal borgere";"Færdigvacc. (%)";"Kumuleret antal færdigvacc."
2021-01-04;Nationalt;1;5857555;0.00;1
2021-01-07;Nationalt;1;5857555;0.00;2
2021-01-08;Nationalt;1;5857555;0.00;3
2021-01-09;Nationalt;1;5857555;0.00;4
2021-01-12;Nationalt;1;5857555;0.00;5
2021-01-13;Nationalt;1;5857555;0.00;6
2021-01-14;Nationalt;1;5857555;0.00;7
2021-01-15;Nationalt;5;5857555;0.00;12
2021-01-16;Nationalt;8;5857555;0.00;20
2021-01-17;Nationalt;664;5857555;0.01;684
2021-01-18;Nationalt;2032;5857555;0.05;2716
2021-01-19;Nationalt;1983;5857555;0.08;4699
2021-01-20;Nationalt;1790;5857555;0.11;6489
2021-01-21;Nationalt;2260;5857555;0.15;8749
2021-01-22;Nationalt;5494;5857555;0.24;14243
2021-01-23;Nationalt;6788;5857555;0.36;21031
2021-01-24;Nationalt;6185;5857555;0.46;27216
2021-01-25;Nationalt;2378;5857555;0.51;29594
2021-01-26;Nationalt;1674;5857555;0.53;31268
2021-01-27;Nationalt;4235;5857555;0.61;35503
2021-01-28;Nationalt;7970;5857555;0.74;43473
2021-01-29;Nationalt;17737;5857555;1.04;61210
2021-01-30;Nationalt;12434;5857555;1.26;73644
2021-01-31;Nationalt;11719;5857555;1.46;85363
2021-02-01;Nationalt;7681;5857555;1.59;93044
2021-02-02;Nationalt;2943;5857555;1.64;95987
2021-02-03;Nationalt;6069;5857555;1.74;102056
2021-02-04;Nationalt;10721;5857555;1.93;112777
2021-02-05;Nationalt;13095;5857555;2.15;125872
2021-02-06;Nationalt;6614;5857555;2.26;132486
2021-02-07;Nationalt;3564;5857555;2.32;136050
2021-02-08;Nationalt;6896;5857555;2.44;142946
2021-02-09;Nationalt;4784;5857555;2.52;147730
2021-02-10;Nationalt;3831;5857555;2.59;151561
2021-02-11;Nationalt;2427;5857555;2.63;153988
2021-02-12;Nationalt;7580;5857555;2.76;161568
2021-02-13;Nationalt;955;5857555;2.77;162523
2021-02-14;Nationalt;619;5857555;2.79;163142
2021-02-15;Nationalt;3116;5857555;2.84;166258
2021-02-16;Nationalt;1314;5857555;2.86;167572
2021-02-17;Nationalt;425;5857555;2.87;167997
2021-02-18;Nationalt;311;5857555;2.87;168308
2021-02-19;Nationalt;954;5857555;2.89;169262
2021-02-20;Nationalt;574;5857555;2.90;169836
2021-02-21;Nationalt;357;5857555;2.91;170193
2021-02-22;Nationalt;1105;5857555;2.92;171298
2021-02-23;Nationalt;1917;5857555;2.96;173215
2021-02-24;Nationalt;1918;5857555;2.99;175133
2021-02-25;Nationalt;619;5857555;3.00;175752
2021-02-26;Nationalt;1011;5857555;3.02;176763
2021-02-27;Nationalt;1415;5857555;3.04;178178
2021-02-28;Nationalt;1374;5857555;3.07;179552
2021-03-01;Nationalt;1060;5857555;3.08;180612
2021-03-02;Nationalt;1279;5857555;3.11;181891
2021-03-03;Nationalt;1017;5857555;3.12;182908
2021-03-04;Nationalt;1798;5857555;3.15;184706
2021-03-05;Nationalt;5670;5857555;3.25;190376
2021-03-06;Nationalt;3926;5857555;3.32;194302
2021-03-07;Nationalt;4290;5857555;3.39;198592
2021-03-08;Nationalt;6393;5857555;3.50;204985
2021-03-09;Nationalt;7126;5857555;3.62;212111
2021-03-10;Nationalt;7163;5857555;3.74;219274
2021-03-11;Nationalt;7915;5857555;3.88;227189
2021-03-12;Nationalt;10496;5857555;4.06;237685
2021-03-13;Nationalt;5857;5857555;4.16;243542
2021-03-14;Nationalt;9296;5857555;4.32;252838
2021-03-15;Nationalt;9795;5857555;4.48;262633
2021-03-16;Nationalt;9385;5857555;4.64;272018
2021-03-17;Nationalt;9100;5857555;4.80;281118
2021-03-18;Nationalt;7201;5857555;4.92;288319
2021-03-19;Nationalt;11669;5857555;5.12;299988
2021-03-20;Nationalt;4785;5857555;5.20;304773
2021-03-21;Nationalt;4631;5857555;5.28;309404
2021-03-22;Nationalt;7720;5857555;5.41;317124
2021-03-23;Nationalt;7541;5857555;5.54;324665
2021-03-24;Nationalt;13404;5857555;5.77;338069
2021-03-25;Nationalt;8381;5857555;5.91;346450
2021-03-26;Nationalt;7818;5857555;6.05;354268
2021-03-27;Nationalt;3097;5857555;6.10;357365
2021-03-28;Nationalt;2803;5857555;6.15;360168
2021-03-29;Nationalt;6185;5857555;6.25;366353
2021-03-30;Nationalt;6037;5857555;6.36;372390
2021-03-31;Nationalt;9725;5857555;6.52;382115
2021-04-01;Nationalt;6905;5857555;6.64;389020
2021-04-02;Nationalt;6981;5857555;6.76;396001
2021-04-03;Nationalt;2187;5857555;6.80;398188
2021-04-04;Nationalt;1779;5857555;6.83;399967
2021-04-05;Nationalt;1327;5857555;6.85;401294
2021-04-06;Nationalt;6103;5857555;6.96;407397
2021-04-07;Nationalt;8232;5857555;7.10;415629
2021-04-08;Nationalt;8568;5857555;7.24;424197
2021-04-09;Nationalt;8676;5857555;7.39;432873
2021-04-10;Nationalt;5444;5857555;7.48;438317
2021-04-11;Nationalt;3919;5857555;7.55;442236
2021-04-12;Nationalt;11529;5857555;7.75;453765
2021-04-13;Nationalt;6252;5857555;7.85;460017
2021-04-14;Nationalt;11176;5857555;8.04;471193
2021-04-15;Nationalt;9114;5857555;8.20;480307
2021-04-16;Nationalt;8176;5857555;8.34;488483
2021-04-17;Nationalt;2746;5857555;8.39;491229
2021-04-18;Nationalt;5142;5857555;8.47;496371
2021-04-19;Nationalt;14395;5857555;8.72;510766
2021-04-20;Nationalt;16971;5857555;9.01;527737
2021-04-21;Nationalt;12753;5857555;9.23;540490
2021-04-22;Nationalt;5401;5857555;9.32;545891
2021-04-23;Nationalt;11219;5857555;9.51;557110
2021-04-24;Nationalt;7595;5857555;9.64;564705
2021-04-25;Nationalt;5288;5857555;9.73;569993
2021-04-26;Nationalt;7881;5857555;9.87;577874
2021-04-27;Nationalt;20914;5857555;10.2;598788
2021-04-28;Nationalt;20580;5857555;10.6;619368
2021-04-29;Nationalt;17939;5857555;10.9;637307
2021-04-30;Nationalt;3959;5857555;10.9;641266
2021-05-01;Nationalt;6127;5857555;11.1;647393
2021-05-02;Nationalt;13803;5857555;11.3;661196
2021-05-03;Nationalt;45728;5857555;12.1;706924
2021-05-04;Nationalt;24792;5857555;12.5;731716
2021-05-05;Nationalt;29250;5857555;13.0;760966
2021-05-06;Nationalt;25564;5857555;13.4;786530
2021-05-07;Nationalt;24612;5857555;13.8;811142
2021-05-08;Nationalt;30841;5857555;14.4;841983
2021-05-09;Nationalt;16703;5857555;14.7;858686
2021-05-10;Nationalt;36153;5857555;15.3;894839
2021-05-11;Nationalt;26273;5857555;15.7;921112
2021-05-12;Nationalt;27007;5857555;16.2;948119
2021-05-13;Nationalt;19706;5857555;16.5;967825
2021-05-14;Nationalt;30797;5857555;17.0;998622
2021-05-15;Nationalt;19452;5857555;17.4;1018074
2021-05-16;Nationalt;14084;5857555;17.6;1032158
2021-05-17;Nationalt;30171;5857555;18.1;1062329
2021-05-18;Nationalt;30810;5857555;18.7;1093139
2021-05-19;Nationalt;22645;5857555;19.0;1115784
2021-05-20;Nationalt;22366;5857555;19.4;1138150
2021-05-21;Nationalt;19282;5857555;19.8;1157432
2021-05-22;Nationalt;11897;5857555;20.0;1169329
2021-05-23;Nationalt;6197;5857555;20.1;1175526
2021-05-24;Nationalt;9730;5857555;20.2;1185256
2021-05-25;Nationalt;12904;5857555;20.5;1198160
2021-05-26;Nationalt;12130;5857555;20.7;1210290
2021-05-27;Nationalt;12419;5857555;20.9;1222709
2021-05-28;Nationalt;9754;5857555;21.0;1232463
2021-05-29;Nationalt;5236;5857555;21.1;1237699
2021-05-30;Nationalt;6980;5857555;21.2;1244679
2021-05-31;Nationalt;21512;5857555;21.6;1266191
2021-06-01;Nationalt;17689;5857555;21.9;1283880
2021-06-02;Nationalt;17404;5857555;22.2;1301284
2021-06-03;Nationalt;23736;5857555;22.6;1325020
2021-06-04;Nationalt;14296;5857555;22.9;1339316
2021-06-05;Nationalt;7509;5857555;23.0;1346825
2021-06-06;Nationalt;15139;5857555;23.3;1361964
2021-06-07;Nationalt;21860;5857555;23.6;1383824
2021-06-08;Nationalt;24686;5857555;24.0;1408510
2021-06-09;Nationalt;24249;5857555;24.5;1432759
2021-06-10;Nationalt;17521;5857555;24.8;1450280
2021-06-11;Nationalt;18337;5857555;25.1;1468617
2021-06-12;Nationalt;12900;5857555;25.3;1481517
2021-06-13;Nationalt;13381;5857555;25.5;1494898
2021-06-14;Nationalt;22101;5857555;25.9;1516999
2021-06-15;Nationalt;18645;5857555;26.2;1535644
2021-06-16;Nationalt;25987;5857555;26.7;1561631
2021-06-17;Nationalt;21626;5857555;27.0;1583257
2021-06-18;Nationalt;27227;5857555;27.5;1610484
2021-06-19;Nationalt;18040;5857555;27.8;1628524
2021-06-20;Nationalt;15724;5857555;28.1;1644248
2021-06-21;Nationalt;26020;5857555;28.5;1670268
2021-06-22;Nationalt;27102;5857555;29.0;1697370
2021-06-23;Nationalt;32629;5857555;29.5;1729999
2021-06-24;Nationalt;34483;5857555;30.1;1764482
2021-06-25;Nationalt;32794;5857555;30.7;1797276
2021-06-26;Nationalt;22588;5857555;31.1;1819864
2021-06-27;Nationalt;24272;5857555;31.5;1844136
2021-06-28;Nationalt;34312;5857555;32.1;1878448
2021-06-29;Nationalt;42245;5857555;32.8;1920693
2021-06-30;Nationalt;38618;5857555;33.4;1959311
2021-07-01;Nationalt;40632;5857555;34.1;1999943
2021-07-02;Nationalt;44099;5857555;34.9;2044042
2021-07-03;Nationalt;32703;5857555;35.5;2076745
2021-07-04;Nationalt;29354;5857555;36.0;2106099
2021-07-05;Nationalt;43105;5857555;36.7;2149204
2021-07-06;Nationalt;42298;5857555;37.4;2191502
2021-07-07;Nationalt;39652;5857555;38.1;2231154
2021-07-08;Nationalt;36889;5857555;38.7;2268043
2021-07-09;Nationalt;33208;5857555;39.3;2301251
2021-07-10;Nationalt;21753;5857555;39.7;2323004
2021-07-11;Nationalt;21999;5857555;40.0;2345003
2021-07-12;Nationalt;54555;5857555;41.0;2399558
2021-07-13;Nationalt;49675;5857555;41.8;2449233
2021-07-14;Nationalt;44762;5857555;42.6;2493995
2021-07-15;Nationalt;53492;5857555;43.5;2547487
2021-07-16;Nationalt;43503;5857555;44.2;2590990
2021-07-17;Nationalt;26410;5857555;44.7;2617400
2021-07-18;Nationalt;33926;5857555;45.3;2651326
2021-07-19;Nationalt;54579;5857555;46.2;2705905
2021-07-20;Nationalt;56532;5857555;47.2;2762437
2021-07-21;Nationalt;55119;5857555;48.1;2817556
2021-07-22;Nationalt;51798;5857555;49.0;2869354
2021-07-23;Nationalt;43694;5857555;49.7;2913048
2021-07-24;Nationalt;23746;5857555;50.1;2936794
2021-07-25;Nationalt;31580;5857555;50.7;2968374
2021-07-26;Nationalt;42060;5857555;51.4;3010434
2021-07-27;Nationalt;44830;5857555;52.2;3055264
2021-07-28;Nationalt;43315;5857555;52.9;3098579
2021-07-29;Nationalt;39007;5857555;53.6;3137586
2021-07-30;Nationalt;34827;5857555;54.2;3172413
2021-07-31;Nationalt;20053;5857555;54.5;3192466
2021-08-01;Nationalt;19199;5857555;54.8;3211665
2021-08-02;Nationalt;40660;5857555;55.5;3252325
2021-08-03;Nationalt;43086;5857555;56.3;3295411
2021-08-04;Nationalt;44613;5857555;57.0;3340024
2021-08-05;Nationalt;39915;5857555;57.7;3379939
2021-08-06;Nationalt;39999;5857555;58.4;3419938
2021-08-07;Nationalt;27013;5857555;58.8;3446951
2021-08-08;Nationalt;35953;5857555;59.5;3482904
2021-08-09;Nationalt;55505;5857555;60.4;3538409
2021-08-10;Nationalt;54791;5857555;61.3;3593200
2021-08-11;Nationalt;57586;5857555;62.3;3650786
2021-08-12;Nationalt;50171;5857555;63.2;3700957
2021-08-13;Nationalt;46951;5857555;64.0;3747908
2021-08-14;Nationalt;35379;5857555;64.6;3783287
2021-08-15;Nationalt;37505;5857555;65.2;3820792
2021-08-16;Nationalt;45083;5857555;66.0;3865875
2021-08-17;Nationalt;37722;5857555;66.6;3903597
2021-08-18;Nationalt;36638;5857555;67.3;3940235
2021-08-19;Nationalt;26514;5857555;67.7;3966749
2021-08-20;Nationalt;28763;5857555;68.2;3995512
2021-08-21;Nationalt;19700;5857555;68.5;4015212
2021-08-22;Nationalt;16190;5857555;68.8;4031402
2021-08-23;Nationalt;30407;5857555;69.3;4061809
2021-08-24;Nationalt;28701;5857555;69.8;4090510
2021-08-25;Nationalt;18744;5857555;70.2;4109254
2021-08-26;Nationalt;18391;5857555;70.5;4127645
2021-08-27;Nationalt;20382;5857555;70.8;4148027
2021-08-28;Nationalt;10027;5857555;71.0;4158054
2021-08-29;Nationalt;11735;5857555;71.2;4169789
